##|||||||||||||||||||||||||||||||||||||||||||||||||||||######_~_### ##|;;;;;;;;;;;;;;;;;;;;;;;;;;;;;;;;;;;;;;;;;;;;;;;;;||#######_~_### 
##|;;H;;#°°###;;;;;;;;;;;;;;;;;;;;;;;;;;;;;;;;;;|||||#######_~_#### 
##|;;;;;##°°°°####;;;;;;;;;;;;;;;;;;;;;;;;;;;;;;|___#######_~_##### 
##||;;;;#####°°######;;;;;;;;;;;;;;;;;;;;;;;;;;;~~~~__###__~_###### 
####|;;;#####°°#~~######;;;;;;##;;;;;;;;;;;;;;;;____~~___~~~~__#### #####||;;;###°###~~~################;;;;;;;;;;;#####__~~~____~~_### 
#######|;;;;#°°#°##~~~~###############################___####__~_## 
########|;;;;###°°°°##~~~~~~##################################_~_## #########|;;;;#####°°##H∙####~~≈####__________#################_~__ ##########|;;;;;#;##∙∙∙∙∙∙###~#≈≈≈≈≈≈≈≈≈≈≈≈≈≈≈≈≈≈###############_~~ ###########|;;;;;;∙∙∙####∙∙∙-∙∙∙∙∙∙#__________###≈≈≈≈≈≈≈#########__ ###########|;;;;;;;#######~~°°####∙∙∙∙∙∙∙∙∙∙∙∙∙∙∙∙∙∙∙##≈≈≈######### ###########||;;;;;;;#####~#°°#######################∙∙H##≈≈######## #############|;;;;;#####~#°°##;######################∙####≈######## #############||;;;;####~#°°##;;;;;||||##############∙∙###≈≈######## ##############|;;;;###~#°°##;;;;;;;;;|##############∙###≈≈######### ##############|;;;;##°°°°##;;;;;;;;#################∙##≈≈########## ##############|;;;##°°###;;;;;;;;;°°°°°#############∙##≈≈########## ##############;|;;#####;;;;;;;;;;#####°#############∙###≈########## ################|;;;;;;;;;;;;;;;;#####°°°°°°°°°°°°##∙###≈########## #################||||;;;;;;;;;;##################°°°∙∙∙∙-∙∙∙####### #####################|;;;;;;;;;############~~~~~~~~###H#≈##∙∙###### ######################|;;;;;;;;~~~H######~~~######~~~~~~≈≈##∙∙##### #######################|;;;;;;###~~~~~~~~~###############≈≈##∙∙#### ########################|;;;;#############################≈≈##∙∙### ########################|;;;;;#############################≈≈##∙### ######################||;;;;;;##############################≈≈#∙∙## ######################|;;;;;#################################≈≈#∙∙# #####################|;;;;;;;#################################≈≈#∙#